111111111111111111111111111111111111111111111111111111111111111111111111111111111111111111111111111
100000000000000000000000000000000000000000000000000000000000000000000000000000000000000000000000001
100000000000000000000000000000000000000000000000000000000000000000000000000000000000000000000000001
1000CCCCC0C00000CCCCC0C000C0E0000000000000000000000000000000000000000000000000000000000000000000001
1000C000C0C00000C00000CC0CC000000000000000000000000000000000000000000000000000000000000000000000001
1000C000C0C00000C000000CCC00C0000000000000000000000000000000000000000000000000000000000000000000001
1000CCCCC0C00000CCC00000C00000000000000000000000000000000000000000000000000000000000000000000000001
1000C000C0C00000C0000000C000C0000000000000000000000000000000000000000000000000000000000000000000001
1000C000C0C00000C000000CCC00C0000000000000000000000000000000000000000000000000000000000000000000001
1000C000C0C00000C00000CC0CC0C0000000000000000000000000000000000000000000000000000000000000000000001
1000P000C0CCCCC0CCCCC0C000C0C0000000000000000000000000000000000000000000000000000000000000000000001
100000000000000000000000000000000000000000000000000000000000000000000000000000000000000000000000001
100000000B00000000000000000000000000000000000000000000000000000000000000000000000000000000000000001
100000000000000000000000000000000000000000000000000000000000000000000000000000000000000000000000001
100000000000000000000000000000000000000000000000000000000000000000000000000000000000000000000000001
100000000000000000000000000000000000000000000000000000000000000000000000000000000000000000000000001
100000000000000000000000000000000000000000000000000000000000000000000000000000000000000000000000001
100000000000000000000000000000000000000000000000000000000000000000000000000000000000000000000000001
100000000000000000000000000000000000000000000000000000000000000000000000000000000000000000000000001
100000000000000000000000000000000000000000000000000000000000000000000000000000000000000000000000001
100000000000000000000000000000000000000000000000000000000000000000000000000000000000000000000000001
111111111111111111111111111111111111111111111111111111111111111111111111111111111111111111111111111
