1111111111111
1P0C00101C001
10100C0010101
1C0010100C1E1
1111111111111
