11111111111111111
1CCC1111CCC111111
1CCC1111CCC111111
1CCC1111CCC111111
1CCC1111CCC111111
11111111111111111
1111CCC1111111111
1111CCC1111111111
1111CCC1111111111
11111111111111111
11111111111111111
11111P11111111111
11111111111111111

