11111111111111111
1CCC1111CCC111111
1CCC1111CCC111111
1CCC1111CCC111111
1CCC1111CCC111111
11100E00001111111
1111C0C1111111111
1111CCC1111111111
1111CCC1111111111
11110001111111111
11110000111111111
11111P11111111111
11111111111111111


111111111111111111