11111111111111111
10001111000111111
10001111000111111
10001111000111111
10001111000111111
11100E0000CCC1111
11110001111111111
11110001111111111
11110001111111111
11110001111111111
11110000111111111
11111P11111111111
11111111111111111
11111111111111111
11111111111111111
11111111111111111
11111111111111111
11111111111111111
11111111111111111
11111111111111111
